R 1920	1080
NO abcdef 
SO ghijkl
EA mnopqr
WE stuvwx

S yz
F 220,100,0
C 225,30,0





 111111111111111111111111111111111
10000000000000000000000000000000001
10000000000000000000000000000000001
1000000000000000000111111111111111
1000000000000000001
1000000000000000001
 11111111111111111
