R 1920 1080
NO
SO
EA
WE

S
F 220,100,0
C 225,30,0

1111111111
1000000001
1000000001
1000000001
1000000001
1000000001
1000000001
1000000001
1000000001
1111111111

